##########################################
#%                             %         #
# ##########    ################   ####  #
#                                        #
# #          #  ####           ########  #
# #   %     #       #     #           #  #
# #        #         #          #    ##  #
# #       #           #               #  #
#                          #    ##    #  #
# #     ###           #              ##  #
# #        #         #     ##   @        #
# #          #      #           #    ##  #
# #     # #        #                  #  #
#           #  ########## #####          #
# #                             #     #  #
# # ##  %    #######      ###         #  #
# #                              #    #  #
# ## ########  ######      #   # ###     #
#                      %     #        #  #
##########################################