##########################################
#%    &                        %         #
# ##########  & ################   ####  #
#                                        #
# #          #  ####           ########  #
# #   %     #       #     #           #  #
# #        #         #   % &    #    ##  #
# #       #           #               #  #
#               &          #    ##    #  #
# #     ###           #              ##  #
# #        #         #     ##   @        #
# #          #      #           #    ##  #
# #     # #        #                  #  #
#     &     #  ########## #####          #
# #                             #     #  #
# # ##  %    #######      ###         #  #
# #                              #    #  #
# ## ########  ######      #   # ###     #
#                      %     #        #  #
##########################################